111111111111111111111111111111111111111
1CE000000000000000000000000000000000001
1000000000000C1111111111111111111111111
100001000000000000000100000000000000001
100001000000000000000100000000000000001
100001000000000000000100000000000000001
100001000000000000000100000000000000001
100001000000000C00000100000000000000001
100001000000000000000100000000000000001
1000010000P0000000000100000000000000001
100001000000000C00000100000000000000001
100001000000000000000100000000000000001
100001000000000000000100000000000000001
10000100C000000000000100000000000000001
100001000000000000000100000000000000001
1000010000000000000001000000000000000E1
111111111111111111111111111111111111111