11111111111111111111111
1CE00000000000000000001
1000000000000C000000001
10000000000000000000001
10000000000000000000001
100000000000000C0000001
10000000000000000000001
1000000000P000000000001
10000C000000000C0000001
10000000000000000000001
10000000000000000000001
10000000C00000000000001
10000000000000000000001
100000000000000000000E1
11111111111111111111111