1111111111111111111111111111111111111111
1111111111100000000000000000001111111111
1111111111101110111010111011101111111111
1111111111101C0010001000100C101111111111
1111111111101000000010000000101111111111
1111111111100001111010111100001111111111
1111111111101101E00000001101101111111111
1111111111101001000000000100101111111111
1111111111101001000000000100101111111111
1111111111100000000000000000001111111111
11111111111011110000P0000111101111111111
1111111111100000000000000000001111111111
1111111111101001000000000100101111111111
1111111111101001000000000100101111111111
111111111110110110000000E101101111111111
1111111111100001111010111100001111111111
1111111111101000000010000000101111111111
1111111111101C0010001000100C101111111111
1111111111101110111010111011101111111111
1111111111100000000000000000001111111111
1111111111111111111111111111111111111111
1111111111111111111111111111111111111111